1111111111111111111111111111111111111111111111111111111111111111111111111111111111111
1000000000000000000000000000000000000000000000000000000000000000000000000000000001111
100C00000000000000000000000000000000000000000000000000000000000000000000000000C001111
1000000000000000000000000000000000000000000000000000000000000000000000000000000001111
1000000000000000000000000000000000000000000000000000000000000000000000000000000001111
1000000000000000000000000000000000000000000000000000000000000000000000000000000001111
1000000000001100000000000110001111111100001111111100001111111100000000000000000001111
1000000000000110000000001100000001100000000001100000000001100000000000000000000001111
1000000000000011000000011000000001100000000001100000000001100000000000000000000001111
1000000000000001100C00110000C00001100000P00001100000C00001100000000000000000E00001111
1000000000000000110001100000000001100000000001100000000001100000000000000000000001111
1000000000000000011011000000000001100000000001100000000001100000000000000000000001111
1000000000000000001110000000001111111100000001100000001111111100000000000000000001111
1000000000000000000000000000000000000000000000000000000000000000000000000000000001111
1000000000000000000000000000000000000000000000000000000000000000000000000000000001111
1000000000000000000000000000000000000000000000000000000000000000000000000000000001111
1000000000000000000000000000000000000000000000000000000000000000000000000000000001111
100C00000000000000000000000000000000000000000000000000000000000000000000000000C001111
1000000000000000000000000000000000000000000000000000000000000000000000000000000001111
1111111111111111111111111111111111111111111111111111111111111111111111111111111111111