1111111111111111111
1111111C00000P00111
11111111100C0000111
1111111110011110001
1110C10010001111111
1110011110E01111111
1110000C00001111111
11001100011C1111111
1111111111111111111