111111111111
10000000P011
110000000001
1E01100011C1
111111111111